11111111111111111111111111111
1010000C000C01000C0000E000101
10C0C000100100000000000010101
10000000C0000C000000000010001
1000000000000000100100001C001
100000000000000001CC00C000001
100100010000000001000000C0001
10000000010000000100101100001
1000001C00000C000000010CC0001
11C00000C00C00000C00000010001
10001000010CC00000001010010C1
100000010C00C000C00000C0CC0C1
10000010000000000000000010001
1000C000001100000C001001001C1
100000000000C0000000001100C01
10000001001000000001100100001
100P0000000000000000000000001
101C001C0000C000000C010010001
10000000101000000000000000001
1000000000100000C100C00001011
1001C001000C00000000000000001
1010C01000100C000010000000001
1000C10000000000C010100000011
100000000000100000C00C1000001
10000000000000000000000000001
11111111111111111111111111111