1111111111111111111111111111111
1E0000000000001C00000C000000101
1010010100100011111001000010101
1000010010101010001001000010001
1010010010000010001001000010001
1000010010100000001000000010001
1010000010000010000001000010001
1010000010101010001001000000001
1010010000101000001001000010001
1010010010101010001001000010001
1P0000010C00C0001000000000001C1
1111111111111111111111111111111
