1111111111
1000000EC1
1110000001
1P00000001
1111111111