11111111111111111111111111111
1E1000000000001C000C000000101
10100101001000111001000010101
10000100101010100001000010001
11100100100000100001000010001
10000100101000000000000010001
10100000100000100001000010001
10100000101010100001000000001
10100100001010000001000010001
10100100101010100001000010001
1P0000010C00C00010000000001C1
11111111111111111111111111111
