NO ./asset/images/wall/arrow_N.xpm
SO  ./asset/images/wall/arrow_S.xpm
WE   ./asset/images/wall/arrow_W.xpm 
EA ./asset/images/wall/arrow_E.xpm  
G ./asset/images/wall/G.xpm  


C    200,200,200

F   100,100,100


        111111111111111111111111111111111111111111111111111111111111111111111111111111111111111111111111111111
        100000000010000001000000100000010000001000000100000010000001000000100000010000001000000110000000000001
        101100000110000011000001100000110000011000001100000110000011000001100000110000011000001110000000000001
        100100000000000000000000000000000000000000000000000000000000000000000000000000000000000000000000000001
11111111101100000110000011000001100000110000011000G01100000110000011000001100000110000011000001110000000000001
1000000000110000011000001100000110000011000001100000110000011000001100000110000011000001100000111011111C111111
11110111111111011101101110110111011011101101110110111011011101101110110111011011101101110110111000000C0001
1111011111111101110110111011011101101110110111011011101101110110111011011101101110110111011011101010000001
1100000011010101110010111001011100101100010110001011000101100010110001011000101100010110001011000000000001
1000000000000000110000011000001100000110000011000001100000110000011000001100000110000011000001100000010001
1000000000000000CC00000CC00000CC00000CC00000CC00000CC00000CC00000CC00000CC00000CC00000CC00000CC010100C0001
1100000111010101111010111101011110101111010111101011110101111010111101011110101111010111101011111011110N0111
11110111 1110101 100101 100101 100101 100101 100101 100101 100101 100101 100101 100101 100101 101111 10001
11111111 1111111 111111 111111 111111 111111 111111 111111 111111 111111 111111 111111 111111 111111111111