NO ./asset/images/wall/N.xpm
SO  ./asset/images/wall/S.xpm
WE   ./asset/images/wall/W.xpm 
EA ./asset/images/wall/E.xpm  
G ./asset/images/wall/G.xpm  


C    200,200,200

F   100,100,100


        1111111111111111111111111
        1000000000110000000000001
        1011000001110000000000001
        1001000000000000000000001
111111111011000001110000000000001
10000000001100000111011111C111111
111101111111110111000000C0001
11110111111111011101010000001
11000000110101011G00000000001
10000000000000001100000010001
1000000000000000CC010100C0001
11000001110101011111011110N0111
11110111 1110101 101111010001
11111111 1111111 111111111111